R 1080    901                                 
NO ./path_to_the_north_texture
SO ./path_to_the_south_texture    
WE ./path_to_the_west_texture  
EA ./path_to_the_east_texture
S ./path_to_the_sprite_textur      
F 255, 250, 45                                                                          
C 125, 120, 2                                             
    

    11111111111111111111111111
1111100000110000000000001     
1011000001110000002000001111111
100100000000000000000000000111111111
11111111101100000111000000001
100000000011000001110111111111111      
11110111111111011100000010001
11110111111111011101010010001
1100000011010101 100000010001
10002000000000011100000010001            
10000000000000001101010010001
1100000111010101111101111000111
11110111 1110101 1011110100S1
11111111 1111111 111111111111



