R 1400 720
NO ./srcs/wall.xpm
SO ./srcs/bois.xp
WE ./srcs/brick1.xpm
EA ./srcs/brick.xpm 
S ./srcs/barrel.xpm    
F 64,64,64                                                                       
C 16,16,16 

111111111111111111
100000000000000001
10000000N000000001
100000000000000001
100000000000000001
100000000000000001
100000000200000001
100000000000000001
100000000000000001
111111111111111111
