R 1080 540
NO ./path_to_the_north_texture
SO ./path_to_the_south_texture
WE ./path_to_the_west_texture
EA ./path_to_the_east_texture 
S ./path_to_the_sprite_texture      
F 64,64,64                                                                       
C 16,16,16 

1111111111111111
1000000000000001
1000000000000001
1000000000000001
1000000000000001
1000000001000001
1000000000000001
10000000W0000001
1111111111111111
