R 1080 540
NO ./srcs/mur.xpm
SO ./path_to_the_south_texture
WE ./path_to_the_west_texture
EA ./path_to_the_east_texture 
S ./path_to_the_sprite_texture      
F 64,64,64                                                                       
C 16,16,16 

11111111111111111111111111111111111111111111111111
10000000000000000000000000000000000000000000000001
100000000000000000000000000000000000000000000000011
100000000000100000000000000000000000000000000000001
100000000000000000000000000000000000000000000000011
100000000000000000000000000000000000000000000000011
100000000000000010000000000000000000000000000000001
1000000000000000000000000000000000000000000000000111111
1000000000000000000000000000000000000000111111000000001
10000000000000000000000000000E00000000000000000000111111
1000000000000100000000000000000000000000000000000011111111111111
100000000000000000000000000001000000000000000000000000000000001
100000000000000000000000000000001000000000000000011111111111111
10000000000000000000000000000000000000000000000001
10000000000000000000000000000000000000000000000001
10000000000000000000000000000000000000000000000001
10000000000000000000000000000000000000000000000001
11111111111111111111111111111111111111111111111111
