R 1080 500
NO ./path_to_the_north_texture
SO ./path_to_the_south_texture
WE ./path_to_the_west_texture
EA ./path_to_the_east_texture 
S ./path_to_the_sprite_texture      
F 255, 250, 45                                                                        
C 125, 120, 2   

f
111111111
1000N0021
111111111


                            