R 1080    901                            
NO ./path_to_the_north_texture
SO ./path_to_the_south_texture    
WE ./path_to_the_west_texture  
EA ./path_to_the_east_texture
S ./path_to_the_sprite_textur      
F 255,250 ,  1   250             
C 125,120,   1   0            
    

    11111111111111111111111111
1111100000110000000000001     
1011000001110000002000001111111
1001000000000000000000000000111111111
11111111101100000111000000001
100000000011000001110111111111111
11110111111111011100000010001
11110111111111011101010010001
1100000011010101 100000010001
10002000000000011100000010001            
10000000000000001101010010001
11000001110101011111011110N0111
11110111 1110101 101111010001
11111111 1111111 111111111111



