NO ./srcs/texture/wall.xpm
SO ./srcs/texture/bois.xpm
WE ./srcs/texture/brick1.xpm
EA ./srcs/texture/brick.xpm 
  
F 64,64,64                                                                       
C 16,16,16 



        1111111111111111111111111
        1000000000110000000000001
        1011000001110000000000001
        1001000000000000000000001
111111111011000001110000000000001
100000000011000001110111100011111
11110111111111011100000010001
11110111111111011101010010001
11000000110101011100000010001        111111
1000000000000000000000000000111111111100001
1000000000000000110101001000000000000000001
11000001110101011111011110N0111111111110001
11110111 1110101 101111010001         11111
11111111 1111111 111111111111


